5,5,5,5,5,5,5,5,5,5,5,5,5,5,5,5,5,5,5,5,5,5,68,70,70,70,70,70,69,69,71,5,
5,5,5,5,5,5,5,5,5,5,5,5,5,5,5,5,5,5,5,5,5,5,72,73,73,73,73,73,73,73,75,5,
5,5,5,5,5,5,5,5,5,5,5,5,56,56,56,56,56,56,5,5,5,5,72,48,49,73,73,73,73,73,75,5,
5,5,5,5,5,5,5,5,5,5,5,56,56,4,4,4,4,56,56,5,5,5,76,53,54,77,77,77,77,77,79,5,
5,5,5,5,5,5,5,5,5,5,56,56,4,4,4,4,4,4,4,56,5,5,5,58,59,5,5,5,5,5,5,5,
2,2,2,2,20,22,22,22,22,22,56,4,4,4,4,4,4,4,4,56,22,22,22,22,22,22,18,5,5,5,5,5,
2,2,2,2,17,3,3,3,3,3,56,4,4,4,4,4,4,4,4,56,3,3,3,3,3,3,25,5,5,5,5,5,
2,2,2,2,17,3,7,8,8,8,56,4,4,4,4,4,4,4,4,56,8,8,8,8,10,3,25,5,5,5,5,5,
2,2,2,2,17,3,14,5,5,5,56,4,4,4,4,4,4,4,56,56,5,5,5,2,17,3,25,5,68,69,71,5,
2,2,2,2,17,3,14,5,5,5,5,56,56,4,4,4,4,56,56,5,5,5,2,2,17,3,25,5,72,73,75,5,
2,2,2,2,17,3,14,5,5,5,5,5,4,4,4,4,4,4,5,5,5,5,2,2,17,3,25,5,72,73,75,5,
2,2,2,2,17,3,21,22,22,22,22,22,22,18,50,52,20,22,22,22,22,22,23,23,24,3,25,5,72,73,75,5,
2,2,2,2,17,3,3,3,3,3,3,3,3,25,50,52,17,3,3,3,3,3,3,3,3,3,25,5,72,73,75,5,
2,2,2,2,17,3,3,3,3,3,3,3,3,25,55,57,17,3,3,3,3,3,3,3,3,3,25,5,72,73,75,5,
2,2,2,2,17,3,3,7,9,9,10,3,3,21,55,57,24,3,3,7,8,8,8,48,49,9,11,5,76,77,79,5,
2,2,2,2,17,3,3,25,2,2,17,3,3,3,3,3,3,3,3,14,5,5,5,53,54,5,5,5,5,5,5,5,
2,2,2,2,17,3,3,25,2,2,17,3,3,3,3,41,3,3,3,14,5,5,5,53,54,5,5,5,5,5,5,5,
2,2,2,2,17,3,3,25,2,2,13,8,8,8,10,7,9,9,9,11,5,5,5,53,54,5,5,5,5,5,5,5,
2,2,2,2,17,3,3,25,2,2,2,2,2,2,27,25,5,5,5,5,5,68,69,58,59,70,70,71,5,5,5,5,
2,2,2,2,17,3,3,21,22,22,18,2,2,2,27,25,5,5,5,5,5,72,74,74,74,74,74,75,5,5,5,5,
2,2,2,2,17,3,3,3,3,3,25,2,2,2,27,25,5,5,5,5,5,72,74,74,74,74,74,75,5,5,5,5,
2,2,2,2,17,3,3,3,3,3,25,2,2,2,27,25,5,68,69,70,5,72,74,74,74,74,74,75,5,5,5,5,
2,19,19,19,13,9,9,10,3,3,25,2,2,2,27,25,5,72,73,73,75,72,74,74,74,74,74,75,5,5,5,5,
2,30,31,31,31,32,2,27,3,3,25,2,2,2,17,25,5,72,73,73,75,76,77,78,78,78,77,79,5,5,5,5,
2,36,37,37,37,38,2,27,3,3,14,2,2,2,17,25,5,76,77,78,79,5,5,5,5,5,68,69,69,69,71,5,
2,36,37,37,37,38,2,27,3,3,21,22,22,22,24,25,5,5,5,5,5,5,5,5,5,5,72,73,73,73,75,5,
2,36,37,37,37,38,2,27,3,3,3,3,3,3,3,25,5,5,5,5,5,68,69,70,71,5,76,77,77,77,79,5,
2,36,37,37,37,38,2,27,3,3,3,3,3,3,3,25,5,5,5,5,5,72,73,73,75,5,5,5,5,5,5,5,
2,42,43,43,43,44,2,13,9,9,9,9,9,9,10,25,5,5,5,5,5,76,77,78,79,5,5,5,5,5,5,5,
2,2,2,2,2,2,2,2,2,2,2,2,2,2,17,25,5,5,5,5,5,5,5,5,5,5,5,5,5,5,5,37,
2,2,2,2,2,2,2,2,2,2,2,2,2,2,17,25,5,5,5,5,5,5,5,5,5,5,5,5,5,5,5,5,
2,2,2,2,2,2,2,2,2,2,2,2,2,2,17,25,5,5,5,5,5,5,5,5,5,5,5,5,5,5,5,5